22
15
UUUUUUUUUUUUUUUUUUUUUU
UUUUUUUUUUUUUUUUUUUUUU
UUUUUUUUUUUUUUUUUUUUUU
UUULHHHHHHHHHHHHHHRUUU
UUULFA-FFFFJFFFA-FRUUU
UUULF--FFFM-FFF--FRUUU
UUULFA-FFFM-FFFA-FRUUU
UUULF--FFFM-FFF--FRUUU
UUULFA-FFFM-FFFA-FRUUU
UUULF--FFFM-FFF--FRUUU
UUULFA-FFFM-FFFA-FRUUU
UUULF--FFFM-FFF--FRUUU
UUULFFFFFFM-FFFFFFRUUU
UUULFFFFFFM-FFFFFFRUUU
UUULFFFFFFM-FFFFFFRUUU