35
22
TTTTTTTTTTTTTTTTTTTTTTTTTTTTTTTTTTT
TTTTTTTTTTTTTTTTTTTTTTTTTTTTTTTTTTT
TTTTTTTTTTTTGGGGGGGGTTTTTTTTTTTTTTT
TTTTTTTTGGGGGGGGGGGGGGY----GGTTTTTT
TTTTTTGGGGGGGGGGDGGGGG-----GGGGTTTT
TTTTTTGGGGGGGGGDDDGGGG-----GGGGTTTT
TTTTGGGS---GGGGDDDGGGG-----GGGTTTTT
TTTGGGG----GGGGDDDGGGG-----GGGGTTTT
TTTGGGG----GGGDDDDDDDDDDDDDDDGGTTTT
TTTGGGGGGGGGGGGDDDDDDDDDDDDDDDGGTTT
TTTGGGGGGGGGGGDDDDDDDDDDGGGGGGGGTTT
TTTTP--GGGGDDDDDDDGGGGGGGGGGGGGGTTT
TTTT---GGGGGGGDDDDGGGGGGGGGGGGGTTTT
TTTGDDDDDDDDDDDDDDGGGGGGGGGGTTTTTTT
TTTGDDDDDDDDDDDDDDGGGGGGGGGTTTTTTTT
TTTGGGGGGGGDDDDDDDDDGGGGGGTTTTTTTTT
TTTTGGGGGGGGGGGGGDDDDGGTTTTTTTTTTTT
TTTTGGGGGGGGB---GDDDDGTTTTTTTTTTTTT
TTTTTGGGGGGG----GGDDDGTTTTTTTTTTTTT
TTTTTTTTGGGG----GGGDDDDGGTTTTTTTTTT
TTTTTTTTTTGGGGGGGGGGGDDDDGGTTTTTTTT
TTTTTTTTTTTTTTTTTTTTTDDDDTTTTTTTTTT