27
17
TTTTTTTTTTDDDDDTTTTTTTTTTTT
TTTTTTTGGGDDDDGGGTTTTTTTTTT
TTGGS--GGGGDDDGGGGGGGGGGTTT
TTGG---GGGGDDDGGGGGGGGGGGTT
TTGG---GGGGDDDGGGGGGGGGGGTT
TTGGDDDDDDDDDDGGGGGP--GGGTT
TTTGGGDDDDDDDDGGGGG---GGGGT
TTTTTGGGGGGDDDDDDDDDDDGGGGT
TTTTTTTGGGGDDDDDDDDDDDGGGGT
TTTTGGGGGGGDDDGGGGGGGGGGGGT
TTGGS--GGGGGDDGGB---GGGGGGT
TTGG---GGGGGDDGG----GGGGGTT
TTGG---GGGGDDDGG----GGGGGTT
TTTGDDDDDDDDDDDDDDDDGGGTTTT
TTTTGGDDDDDDDDDDDDDDGGTTTTT
TTTTTTTTTTTTTTTTTTTTTTTTTTT
TTTTTTTTTTTTTTTTTTTTTTTTTTT
