15
10
LHHHHHHHHHHHHHR
LFFFFFFFFFFFFFR
LFFFFFFFFFFFFFR
LFA-FFFFFFFFFFR
LF--FFFFFFFFFFR
LFFFFFFFFFFFFFR
LFFFFFFFFA-FFFR
LFFFFFFFF--FFFR
LFFFFFFFFFFFFFR
LFFFFFM-FFFFFFR