21
13
UUUUUUUUUUUUUUUUUUUUU
UUUUUUUUUUUUUUUUUUUUU
UUUUUUUUUUUUUUUUUUUUU
UUULHHHHHHHHHHHHHRUUU
UUULFFFFFFFFFFFFFRUUU
UUULFFFFFFFFFFFFFRUUU
UUULFA-FFFFFFFFFFRUUU
UUULF--FFFFFFFFFFRUUU
UUULFFFFFFFFFFFFFRUUU
UUULFFFFFFFFA-FFFRUUU
UUULFFFFFFFF--FFFRUUU
UUULFFFFFFFFFFFFFRUUU
UUULFFFFFM-FFFFFFRUUU