35
51
TTTTTTTTTTTTTTTTTTTTTTDDDTTTTTTTTTT
TTTTTTTTTTTTTTTTTTTTTDDDDTTTTTTTTTT
TTTTTTTTTTTTTTTTTTTTTTDDDDTTTTTTTTT
TTTTTTTTTTTTTTTTTTTTTWWWWWTTTTTTTTT
TTTTTTTTTTTTTTTTTTTTWWWWWWWTTTTTTTT
TTTTTTTTTTTTTTTTTTTTTTWWWWWTTTTTTTT
TTTTTTTTTTTTTTTTTTTTGGGDDDGGGTTTTTT
TTTTTTTTTTTTTTTTTTTTGGGGDDDDGTTTTTT
TTTTTTTTTTTTTTTTTTTTTGGGGDDDDDGGTTT
TTTTTTTTTTTTTTTTTTTTGGGGGDDDDDGGTTT
TTTTTTTTTTTTTTTTTTDDDDDDDDDDDGGGTTT
TTTTTTTTTTTTTGGGGDDDDDDDDDGGTTTTTTT
TTTTTTTTTTTGGGDDDDDDDDDGGGTTTTTTTTT
TTTTTTTTGGGGDDDWWWGGTTTTTTTTTTTTTTT
TTTTTTTGGGDDDDWWWGGGTTTTTTTTTTTTTTT
TTTTTGGGDDDWWWWWGGGTTTTTTTTTTTTTTTT
TTTTGGGDDDGGGGWWGGTTTTTTTTTTTTTTTTT
TTGGGDDDDGGGGGGGGTTTTTTTTTTTTTTTTTT
TTTTGGGDDDDGGGGGGGGTTTTTTTTTTTTTTTT
TTTTTTTTTDDDGGGGGGGGGTTTTTTTTTTTTTT
TTTTTTGGGGDDDDGGGGGGTTTTTTTTTTTTTTT
TTTTTTTGGGGDDDDGGGGTTTTTTTTTTTTTTTT
TTTTTTTGGGDDDGGGGGTTTTTTTTTTTTTTTTT
TTTTTGGGGDDGGGGGGGTTTTTTTTTTTTTTTTT
TTTTTTTTDDDDGGGGGTTTTTTTTTTTTTTTTTT
TTTTTTTGGGGDDDGGGGTTTTTTTTTTTTTTTTT
TTTTTTTGGGGGDDDGGGGGTTTTTTTTTTTTTTT
TTTTTGGGGGGDDDGGGGTTTTTTTTTTTTTTTTT
TTTTTTTTTGGGDDDGGGGGGGGGGGWWTTTTTTT
TTTTTTTTTTTWWWWWWWWWWWWWWWWWTTTTTTT
TTTTTTTTTTTWWWWWWWWWWWWWWWWWTTTTTTT
TTTTTTTTTTTWWWWGWWWWWWWWWWWWTTTTTTT
TTTTTTTTTTTWWWWWWWWWWWWWWWWWTTTTTTT
TTTTTTTTTTTWWWWWWWGWWWWWWWWWTTTTTTT
TTTTTTTTTTTWWWWWWWWWWWWWWWWWTTTTTTT
TTTTTTTTTTTWWWWWWWWWWWWWWGWWTTTTTTT
TTTTTTTTTTTWWWGWWWWWWWWWWWWWTTTTTTT
TTTTTTTTTTTGGGGGGGDDDGGGGGGGTTTTTTT
TTTTTTTTTTTTTGGGGGGDDDDDGGGGTTTTTTT
TTTTTTTTTTTTTGGGGGGGDDDDGGGGGTTTTTT
TTTTTTTTTTTTTTGGGGGGGDDDGGGGGGGTTTT
TTTTTTTTTTTTTTGGGGGGGGDDDGGGGWWWWWT
TTTTTTTTTTTTTTTGGGGGGGDDGGGGGWWWWWT
TTTTTTTTTTTTTTTGGGGGGDDDDDGGGWWWWWT
TTTTTTTTTTTTTGGGGGGDDDDDDDGGGWWWWWT
TTTTTTTTTTTTTTGGGDDDDDDDDGGGWWWWWWT
TTTTTTTTTTTGGGGDDDDDDGGWWWWWWWWWTTT
TTTTTTTTGGGGGGDDDDGWWWWWWWWWWWWWTTT
TTTTTTTGGGGGGGDDDDDDGGWWWWWWWTTTTTT
TTTTTGGGGGGGDDDDDGGGGGGGTTTTTTTTTTT
TTTTTTTTTGGGDDDDDGGGTTTTTTTTTTTTTTT
